111111111111111111111111111111111
1P001C0000000010000000000000000E1
100010T00000001000000000100000001
1000100T0100001111100000100000001
100010T0010000000C100000100000001
1000100T0100000111100000100000001
100010T001000001C0000000100000001
1000100T0100000111111111100000001
1000000001000000000000000000000C1
111111111111111111111111111111111
