111111111111111111111111111111111
1P001C0000000010000000000000000E1
100010000T000010000000001000000T1
100010TTT100T011111T000T100000001
10001000010000000C10T0T01000T0001
10001TTT010T0T011110000010T000001
10001000010T0T01C000TTT0100000001
1000T0TTT1T000T1111111111TTT0TTT1
1000000001000000000000000000000C1
111111111111111111111111111111111
