111111111111111111111111111111111
1P0010C000000010000000000000000E1
100010000000001000000000100000001
100010000100001111100000100000001
10001000010000000C100000100000001
100010000100000111100000100000001
1000100001000001C0000000100000001
100000000100000111111111100000001
100000000100000000000000000000C01
111111111111111111111111111111111
