111111111111
100000100C01
100001000011
1C01CC10EC11
100C100CC0P1
1C0000000001
111111111111